NO ./images/bluestone.xpm
F 250,100,0
C 225,30,0
SO ./images/redbrick.xpm
WE ./images/greystone.xpm

EA ./images/mossy.xpm





        1111111111111111111111111
        1000000000110000000000001
        101100000111000000W000001
        1001000000010000000000001
111111111011000001110000000000001
10000000001100000001D111111111111
11110111111111011100000010001
1111011111111101101010010001
11000000110101011100000010001
10000000000000001100000010001
10000000000000001101010010001
1100000111010101111101111000111
11110111 1110101 101111010001
11111111 1111111 111111111111
